0,0,0,0,0,0,0,0,0,0
0,6,6,1,1,1,1,2,2,3
0,6,6,1,1,1,1,2,3,3
1,1,1,1,1,2,2,3,3,3
1,1,1,1,2,2,3,3,3,4
5,5,5,1,2,2,3,3,4,4
5,5,1,1,1,2,2,2,2,3
5,5,5,1,1,1,1,2,2,2
1,1,5,5,1,1,1,2,2,2
1,1,1,1,1,2,2,2,2,2
1,1,1,1,1,2,2,2,6,6